7 12      
|----------|
|..........|
|F..|..-...|
|..-|.@....|
|.F....--..|
|..........|
|----------|