5 10      
|--------|
|FF.|..-.|
|..-|.@..|
|.F....-.|
|--------|